{
    "spawnObstacles": [
        [ 0, 7, 6, 6, 7 ],
        [ 7, 0, 6, 0, 6 ],
        [ 6, 5, 5, 5, 6 ],
        [ 6, 0, 6, 0, 7 ],
        [ 7, 6, 6, 7, 0 ]
    ],
    "spawnPlanes": [
        [ 0, 0, 0, 3, 0 ],
        [ 0, 0, 0, 0, 2 ],
        [ 0, 1, 0, 3, 0 ],
        [ 4, 0, 0, 0, 0 ],
        [ 0, 1, 0, 0, 0 ]
    ],
    "spawnChangeDirectionOb": [
        [ 0, 0, 1, 0, 0 ],
        [ 0, 0, 0, 0, 0 ],
        [ 1, 0, 0, 0, 0 ],
        [ 0, 0, 0, 0, 0 ],
        [ 4, 0, 0, 0, 0 ]
    ],
    "spawnGoal": [
        [ 0, 0, 0, 0, 1 ],
        [ 0, 0, 0, 0, 0 ],
        [ 0, 0, 0, 0, 0 ],
        [ 0, 0, 0, 0, 0 ],
        [ 0, 0, 0, 0, 0 ]
    ]
}